WAVE 0 TIME 10 ENEMIES A5
WAVE 1 TIME 20 ENEMIES B10
WAVE 2 TIME 5 ENEMIES A5

XX XX XX XX @@ QQ QQ QQ QQ QQ QQ QQ QQ QQ QQ QQ
XX XX XX XX @@ QQ QQ QQ QQ QQ QQ QQ QQ #6 QQ QQ
00 01 02 03 @@ QQ QQ 13 14 15 QQ QQ 28 29 30 QQ
XX XX XX 04 @@ QQ QQ 12 #1 16 QQ #4 27 QQ 31 QQ
XX XX XX 05 @@ QQ #0 11 QQ 17 QQ 25 26 QQ 32 QQ
XX XX XX 06 07 08 09 10 QQ 18 QQ 24 QQ #5 33 QQ
XX XX XX XX @@ QQ QQ QQ QQ 19 QQ 23 QQ QQ 34 35
XX XX XX XX @@ QQ QQ QQ QQ 20 21 22 QQ QQ QQ QQ
XX XX XX XX @@ QQ QQ QQ QQ QQ #3 QQ QQ QQ QQ QQ

XX XX XX XX @@ QQ QQ QQ QQ QQ QQ QQ QQ QQ QQ QQ
XX XX XX XX @@ QQ QQ QQ QQ QQ QQ QQ QQ QQ QQ QQ
XX XX XX XX @@ QQ QQ QQ QQ QQ QQ QQ QQ QQ QQ QQ
XX XX XX XX @@ QQ QQ QQ QQ QQ QQ QQ QQ QQ QQ QQ
XX XX XX XX @@ QQ QQ QQ QQ QQ QQ QQ QQ QQ QQ QQ
XX XX XX XX @@ QQ QQ QQ QQ QQ QQ QQ QQ QQ QQ QQ
XX XX XX XX @@ QQ QQ QQ QQ QQ QQ QQ QQ QQ QQ QQ
XX XX XX XX @@ QQ QQ QQ QQ QQ QQ QQ QQ QQ QQ QQ
XX XX XX XX @@ QQ QQ QQ QQ QQ QQ QQ QQ QQ QQ QQ